R  700          500





NO     ./texture/ WALL0.xpm

SO   ./texture/WALL29.xpm

WE ./texture/WALL31.xpm

EA ./texture/WALL84.xpm

S     ./texture/Wolf3d_tree_v10.xpm

F  100, 100, 0

C    255,  0,255
        1111111111111111111111111
        1000020000110000000000001
        1011000001110222222222201
        1001000000002222222222001
111111111011000001110000000000001
100000000011000001110111111111111
11110111111111011100000002001
11110111111111011101010010001
11000000110101011100002010201
10202000000000001100000010201
10020020000002001101010010001
11000001110101011111011110N0111
11110111 1110101 101111010001
11111111 1111111 111111111111

