R 700    500
NO     ./texture/ WALL0.xpm

SO ./texture/WALL29.xpm

WE ./texture/WALL31.xpm

EA ./texture/WALL84.xpm

S    ./texture/Wolf3d_tree_v10.xpm

F  0, 0, 0

C    255,  255,255

 11111111111
1E00022222221
1000111111111
 1001111
110000001      111111111
1100000011      11111111
10220000001      1111111
102200000001      111111
1000000000001      11111
10220000000001      1201
1022000000001      11111
100000000001       11111
10220000001       111111
1022011111       1111111
10200111        11111111
1020011
102011
1001
1111
