R                      5000       5000
NO                 ./texture/WALL29.xpm
SO     ./texture/WALL29.xpm
EA        ./texture/WALL29.xpm

WE     ./texture/WALL29.xpm

S ./texture/Wolf3d_tree_v10.xpm
F  100   ,  150,   20
C    255,     0,255

          111111111111
          1000000000101
          1020200201001
          10002000010011            1
          1020100201001
          1000110N011011
          1000000000001
          1002222010001         111111
          1000000000001         100001
          1111111111111          110001
          1111111111111          111111
    111
    111

